##########
#O     P #
#  #   X #
#      X #####
# ##         #
#   O    #####
#        #
##########
